1111111111111111111
111X0C0000000000001
100001001P111X00001
10101010C1100C00001
1C1X10X00000XX01111
1010010001XXXX00101
1E100C0101C0000C001
1111111111111111111