1111111111111111
11100C0000000001
100000001P111101
10101010C1100C01
1C1010E001000001
1010010001000001
10100C0001C00001
1111111111111111