1111111111
1011C00011
10E1010011
1000P1C101
1111111111