111111111
1P00C0001
1EC00C001
10000E001
111111111