1111111111
1P00C00000
1EC00C0001
10000E0001
1111111111