1111111111
1P00C00001
1EC00C0001
1000000001
11111111