1111111111
1P00C00001
1EC00C0001
1000000000
1111111111