1111111111
1P00000001
1E00000001
1000000001
1111111111