1111111111
1P000C0001
1E00001001
100001C101
1111111111