1111111111
1P100C0001
11E0010001
100001C101
1111111111